"Titel"	"OGDB-Eintrag"
"a.r.e.s.: extinction agenda ex"	"a.r.e.s.: extinction agenda ex (steam)"
"A.R.E.S.: Extinction Agenda EX"	"A.R.E.S.: Extinction Agenda EX (Steam)"
"ark: survival evolved"	"ark: survival evolved (steam, early access)"
"Ark: Survival Evolved"	"Ark: Survival Evolved (Steam, Early Access)"
"Attack on Titan/ A.O.T.: Wings of Freedom"	"Attack on Titan/ A.O.T.: Wings of Freedom (Steam)"
"attack on titan/ a.o.t.: wings of freedom"	"attack on titan/ a.o.t.: wings of freedom (steam)"
"baphomets fluch 5"	"baphomets fluch 5: der sündenfall - episode 1"
"black mirror"	"black mirror (special edition)"
"crosscode"	"crosscode (steam, early access)"
"CrossCode"	"CrossCode (Steam, Early Access)"
"crossout"	"crossout (steam, early access)"
"Crossout"	"Crossout (Steam, Early Access)"
"darkest dungeon"	"darkest dungeon (steam, early access)"
"darkest hour: a hearts of iron game"	"darkest hour: a hearts of iron game (steam)"
"Darkest Hour: A Hearts of Iron Game"	"Darkest Hour: A Hearts of Iron Game (Steam)"
"Deus Ex: Mankind Divided"	"Deus Ex: Mankind Divided"
"deus ex: mankind divided"	"deus ex: mankind divided"
"die sims 4"	"die sims 4 (limited edition)"
"Dishonored 2"	"Dishonored 2"
"dishonored 2"	"dishonored 2"
"distance"	"distance (steam, early access)"
"Don't Starve Together"	"Don't Starve Together (Steam, Early Access)"
"don't starve together"	"don't starve together (steam, early access)"
"Dragon Ball: Xenoverse"	"Dragon Ball: Xenoverse"
"dragon ball: xenoverse"	"dragon ball: xenoverse"
"Dragon Ball: Xenoverse 2"	"Dragon Ball: Xenoverse 2"
"dragon ball: xenoverse 2"	"dragon ball: xenoverse 2"
"dragon quest heroes"	"dragon quest heroes: der weltenbaum und der tyrann aus der tiefe (day one edition)"
"Dungeon of the Endless"	"Dungeon of the Endless  (Steam)"
"dungeon of the endless"	"dungeon of the endless  (steam)"
"dungeons & dragons: neverwinter"	"dungeons & dragons: neverwinter (gamestar xl 06/2013)"
"ea sports ufc 2"	"ea sports ufc 2"
"EA Sports UFC 2"	"EA Sports UFC 2"
"endless legend"	"endless legend "
"Everspace"	"Everspace (GOG, Early Access)"
"everspace"	"everspace (gog, early access)"
"everybody’s gone to the rapture"	"everybody's gone to the rapture"
"Everybody’s Gone to the Rapture"	"Everybody's Gone to the Rapture"
"F1 2016"	"F1 2016 (Limited Edition)"
"f1 2016"	"f1 2016 (limited edition)"
"fahrenheit: indigo prophecy remastered"	"fahrenheit: indigo prophecy remastered (steam)"
"Fahrenheit: Indigo Prophecy Remastered"	"Fahrenheit: Indigo Prophecy Remastered (Steam)"
"Football Manager 2016"	"Football Manager 2016 (Steam)"
"football manager 2016"	"football manager 2016 (steam)"
"Football Manager 2017"	"Football Manager 2017 (Limited Edition)"
"football manager 2017"	"football manager 2017 (limited edition)"
"forza motorsport 6"	"forza motorsport 6 (ten year anniversary edition)"
"ftl: faster than light"	"ftl: advanced edition"
"gone home"	"gone home (special edition)"
"deponia: the complete journey"	"goodbye deponia"
"Grand Theft Auto V"	"Grand Theft Auto V"
"grand theft auto v"	"grand theft auto v"
"grav: action survival"	"grav: action survival  (steam, early access)"
"grey goo"	"grey goo (steam)"
"Grey Goo"	"Grey Goo (Steam)"
"grim dawn"	"grim dawn (gog)"
"Grim Dawn"	"Grim Dawn (GOG)"
"h1z1"	"h1z1 (steam, early access)"
"h1z1: king of the kill"	"h1z1 (steam, early access)"
"H1Z1: King of the Kill"	"H1Z1 (Steam, Early Access)"
"Half Life 2: Prospekt"	"Half-Life 2"
"half life 2: prospekt"	"half-life 2"
"hard west"	"hard west (collector's edition, steam)"
"Hatred"	"Hatred"
"hatred"	"hatred"
"hearts of iron iv"	"hearts of iron iv"
"Hearts of Iron IV"	"Hearts of Iron IV"
"heroes & generals"	"heroes & generals (steam, early access)"
"higurashi when they cry hou: ch.2 - watanagashi"	"higurashi when they cry hou: ch.2 - watanagashi"
"Homefront: The Revolution"	"Homefront: The Revolution"
"homefront: the revolution"	"homefront: the revolution"
"homeworld: deserts of kharak"	"homeworld: deserts of kharak (steam)"
"Homeworld: Deserts of Kharak"	"Homeworld: Deserts of Kharak (Steam)"
"HuniePop"	"HuniePop"
"huniepop"	"huniepop"
"Hyrule Warriors"	"Hyrule Warriors"
"hyrule warriors"	"hyrule warriors"
"hyrule warriors: legends"	"hyrule warriors: legends"
"Hyrule Warriors: Legends"	"Hyrule Warriors: Legends"
"Jamestown: Legend of the Lost Colony"	"Jamestown: Legend of the Lost Colony (Steam)"
"jamestown: legend of the lost colony"	"jamestown: legend of the lost colony (steam)"
"karmaflow: the rock opera videogame"	"karmaflow: the rock opera videogame (steam)"
"Karmaflow: The Rock Opera Videogame"	"Karmaflow: The Rock Opera Videogame (Steam)"
"kindred spirits on the roof"	"kindred spirits on the roof (steam)"
"Kindred Spirits on the Roof"	"Kindred Spirits on the Roof (Steam)"
"King's Bounty: The Legend"	"King's Bounty: The Legend"
"king's bounty: the legend"	"king's bounty: the legend"
"kung fu panda: showdown of legendary legend - the video game"	"kung fu panda: showdown of legendary legend - the video game (steam)"
"Kung Fu Panda: Showdown of Legendary Legend - The Video Game"	"Kung Fu Panda: Showdown of Legendary Legend - The Video Game (Steam)"
"landwirtschafts-simulator 17"	"landwirtschafts-simulator 17 (collector's edition)"
"Landwirtschafts-Simulator 17"	"Landwirtschafts-Simulator 17 (Collector's Edition)"
"league of legends"	"league of legends (collector's pack)"
"Legend of Legaia"	"Legend of Legaia"
"legend of legaia"	"legend of legaia"
"lego dimensions"	"lego dimensions (starter pack)"
"lego star wars: das erwachen der macht"	"lego star wars: das erwachen der macht"
"LEGO Star Wars: Das Erwachen der Macht"	"LEGO Star Wars: Das Erwachen der Macht"
"LEGO The Hobbit"	"LEGO The Hobbit"
"lego the hobbit"	"lego the hobbit"
"life is strange"	"life is strange: episode 1 - chrysalis"
"mad max (2015)"	"mad max"
"Mad Max (2015)"	"Mad Max"
"infinite air with mark mcmorris"	"mark mcmorris: infinite air (steam)"
"Infinite Air with Mark McMorris"	"Mark McMorris: Infinite Air (Steam)"
"Master of Orion: Conquer the Stars"	"Master of Orion: Conquer the Stars (Collector's Edition) (GOG)"
"master of orion: conquer the stars"	"master of orion: conquer the stars (collector's edition) (gog)"
"metal gear solid"	"metal gear solid"
"Metal Gear Solid"	"Metal Gear Solid"
"mission: impossible - expect the impossible"	"mission: impossible - expect the impossible"
"Mission: Impossible - Expect the Impossible"	"Mission: Impossible - Expect the Impossible"
"monkey island 2 special edition: lechuck's revenge"	"monkey island 2 special edition: lechuck's revenge"
"Monkey Island 2 Special Edition: LeChuck's Revenge"	"Monkey Island 2 Special Edition: LeChuck's Revenge"
"Monster Hunter 4 Ultimate"	"Monster Hunter 4 Ultimate"
"monster hunter 4 ultimate"	"monster hunter 4 ultimate"
"MX vs. ATV Reflex"	"MX vs. ATV Reflex"
"mx vs. atv reflex"	"mx vs. atv reflex"
"NHL 17"	"NHL 17"
"nhl 17"	"nhl 17"
"No Man’s Sky"	"No Man's Sky"
"no man’s sky"	"no man's sky"
"titel"	"ogdb-eintrag"
"Okhlos: Omega"	"Okhlos: Omega (Steam)"
"okhlos: omega"	"okhlos: omega (steam)"
"overwatch"	"overwatch (origins edition)"
"pillars of eternity"	"pillars of eternity (game of the year edition)"
"pokémon sonne"	"pokémon sonne"
"Pokémon Sonne"	"Pokémon Sonne"
"Pokémon: Gelbe Edition"	"Pokémon: Gelbe Edition"
"pokémon: gelbe edition"	"pokémon: gelbe edition"
"pokémon: silberne edition"	"pokémon: goldene edition"
"Pokémon: Silberne Edition"	"Pokémon: Goldene Edition"
"Pokémon: Rubin-Edition"	"Pokémon: Rubin-Edition"
"pokémon: rubin-edition"	"pokémon: rubin-edition"
"pokémon: weisse edition 2"	"pokémon: weisse edition 2"
"Pokémon: Weisse Edition 2"	"Pokémon: Weisse Edition 2"
"pro evolution soccer 2017"	"pro evolution soccer 2017"
"Pro Evolution Soccer 2017"	"Pro Evolution Soccer 2017"
"resident evil: revelations 2"	"resident evil: revelations 2 - extra-episode 1: die prüfung"
"Retro-Pixel Castles"	"Retro-Pixel Castles (Early Access) (Steam)"
"retro-pixel castles"	"retro-pixel castles (early access) (steam)"
"rhythm paradise megamix"	"rhythm paradise megamix"
"Rhythm Paradise Megamix"	"Rhythm Paradise Megamix"
"rise of the tomb raider"	"rise of the tomb raider"
"Rise of the Tomb Raider"	"Rise of the Tomb Raider"
"road redemption"	"road redemption (steam, early access)"
"Rocket League"	"Rocket League"
"rocket league"	"rocket league"
"Runaway 2: The Dream of the Turtle"	"Runaway 2: The Dream of the Turtle"
"runaway 2: the dream of the turtle"	"runaway 2: the dream of the turtle"
"runaway: a twist of fate"	"runaway: a twist of fate"
"Runaway: A Twist of Fate"	"Runaway: A Twist of Fate"
"Salt and Sanctuary"	"Salt and Sanctuary (Steam)"
"salt and sanctuary"	"salt and sanctuary (steam)"
"Secret Files: Tunguska"	"Secret Files: Tunguska"
"secret files: tunguska"	"secret files: tunguska"
"serious sam vr: the last hope"	"serious sam vr: the last hope (steam, early access)"
"Serious Sam VR: The Last Hope"	"Serious Sam VR: The Last Hope (Steam, Early Access)"
"shadow tactics: blades of the shogun"	"shadow tactics: blades of the shogun (limited collector's edition)"
"Shadow Tactics: Blades of the Shogun"	"Shadow Tactics: Blades of the Shogun (Limited Collector's Edition)"
"shadow warrior 2"	"shadow warrior 2 (collectors edition)"
"Shadow Warrior 2"	"Shadow Warrior 2 (Collectors Edition)"
"Sheltered"	"Sheltered (Steam, Early Access)"
"sheltered"	"sheltered (steam, early access)"
"sid meier's civilization v"	"sid meier's civilization v (gold edition)"
"Sid Meier's Civilization VI"	"Sid Meier's Civilization VI"
"sid meier's civilization vi"	"sid meier's civilization vi"
"Sniper Elite"	"Sniper Elite"
"sniper elite"	"sniper elite"
"sorcerer king"	"sorcerer king (steam)"
"Sorcerer King"	"Sorcerer King (Steam)"
"soul calibur v"	"soul calibur v"
"Soul Calibur V"	"Soul Calibur V"
"Spyro 2: Ripto's Rage"	"Spyro 2: Ripto's Rage"
"spyro 2: ripto's rage"	"spyro 2: ripto's rage"
"star trek: armada ii"	"star trek: armada ii"
"Star Trek: Armada II"	"Star Trek: Armada II"
"Star Wars: Battlefront"	"Star Wars: Battlefront"
"star wars: battlefront"	"star wars: battlefront"
"starbound"	"starbound (steam, early access)"
"stardew vally"	"stardew valley (gog)"
"Stardew Vally"	"Stardew Valley (GOG)"
"Starless: Nymphomaniacs' Paradise"	"Starless: Nymphomaniacs' Paradise"
"starless: nymphomaniacs' paradise"	"starless: nymphomaniacs' paradise"
"steep"	"steep (gold edition)"
"Steep"	"Steep (Gold Edition)"
"Steredenn"	"Steredenn (Humble Store)"
"steredenn"	"steredenn (humble store)"
"stranded deep"	"stranded deep (early access, steam)"
"Super Mario Maker"	"Super Mario Maker"
"super mario maker"	"super mario maker"
"super smash bros 4"	"super smash bros. for wii u"
"sword art online: infinity moment"	"sword art online: infinity moment"
"Sword Art Online: Infinity Moment"	"Sword Art Online: Infinity Moment"
"tales from the borderlands"	"tales from the borderlands: episode 1 - zer0 sum"
"technomage - die rückkehr der ewigkeit"	"technomage: die rückkehr der ewigkeit"
"Technomage - Die Rückkehr der Ewigkeit"	"TechnoMage: Die Rückkehr der Ewigkeit"
"the banner saga"	"the banner saga"
"The Banner Saga"	"The Banner Saga"
"The Battle for Wesnoth"	"The Battle for Wesnoth (GameStar 06/2011)"
"the battle for wesnoth"	"the battle for wesnoth (gamestar 06/2011)"
"the brookhaven experiment"	"the brookhaven experiment (steam)"
"The Brookhaven Experiment"	"The Brookhaven Experiment (Steam)"
"The Dwarves"	"The Dwarves"
"the dwarves"	"the dwarves"
"the elder scrolls v: skyrim"	"the elder scrolls v: skyrim"
"The Elder Scrolls V: Skyrim"	"The Elder Scrolls V: Skyrim"
"The Elder Scrolls: Legends"	"The Elder Scrolls: Legends"
"the elder scrolls: legends"	"the elder scrolls: legends"
"the legend of heroes: trails in the sky"	"the legend of heroes: trails in the sky"
"The Legend of Heroes: Trails in the Sky"	"The Legend of Heroes: Trails in the Sky"
"the legend of zelda: majora's mask 3d"	"the legend of zelda: majora's mask 3d"
"The Legend of Zelda: Majora's Mask 3D"	"The Legend of Zelda: Majora's Mask 3D"
"The Legend of Zelda: Ocarina of Time 3D"	"The Legend of Zelda: Ocarina of Time 3D"
"the legend of zelda: ocarina of time 3d"	"the legend of zelda: ocarina of time 3d"
"The Long Dark"	"The Long Dark (Steam, early Access)"
"the long dark"	"the long dark (steam, early access)"
"The Secret of Monkey Island: Special Edition"	"The Secret of Monkey Island: Special Edition"
"the secret of monkey island: special edition"	"the secret of monkey island: special edition"
"the solus project"	"the solus project  (steam, early access)"
"The Solus Project"	"The Solus Project  (Steam, Early Access)"
"the witcher"	"the witcher"
"The Witcher"	"The Witcher"
"the wolf among us"	"the wolf among us: episode 1 - faith"
"titan quest: anniversary edition"	"titan quest: anniversary edition (gog)"
"Titan Quest: Anniversary Edition"	"Titan Quest: Anniversary Edition (GOG)"
"TOCA: World Touring Cars"	"TOCA: World Touring Cars"
"toca: world touring cars"	"toca: world touring cars"
"tom clancy's the division"	"tom clancy's the division"
"Tom Clancy's The Division"	"Tom Clancy's The Division"
"torchlight"	"torchlight"
"Torchlight"	"Torchlight"
"total war: warhammer"	"total war: warhammer"
"Total War: Warhammer"	"Total War: Warhammer"
"ultima vii: the black gate"	"ultima vii: the black gate"
"Ultima VII: The Black Gate"	"Ultima VII: The Black Gate"
"until dawn"	"until dawn"
"Until Dawn"	"Until Dawn"
"until dawn: rush of blood"	"until dawn: rush of blood"
"Until Dawn: Rush of Blood"	"Until Dawn: Rush of Blood"
"war for the overworld"	"war for the overworld (steam)"
"War for the Overworld"	"War for the Overworld (Steam)"
"warhammer: end times - vermintide"	"warhammer: end times - vermintide (collector's edition)"
"wildstar"	"wildstar (deluxe edition)"
"wolfenstein: the old blood"	"wolfenstein: the old blood"
"Wolfenstein: The Old Blood"	"Wolfenstein: The Old Blood"
"wwe 2k17"	"wwe 2k17"
"WWE 2K17"	"WWE 2K17"
"XCOM 2"	"XCOM 2"
"xcom 2"	"xcom 2"
