"Titel"	"Kommentar"
"0h h1"	"s.Rey"
"4 Bilder ein Wort"	"s.Rey"
"8 Ball Pool Billard"	"s.Rey"
"A1"	"?"
"Academagia: The Making of Mages"	"s. Rey"
"Ace of Spades"	"s. Rey"
"Action Henk"	"?"
"Adventure Town"	"?"
"Age of Chivalry"	"OGDB: Half-Life 2"
"Age of Conan"	"(???) Age of Conan"
"Age of Empires: Castle Siege"	"Age of Empires: Castle Siege"
"Age of Mythology (Extended Edition)"	"OGDB: Age of Mythology: Extended Edition"
"Alien Hive"	"OGDB: Alien Hive"
"Alien Isolation"	"OGDB: Alien: Isolation"
"Aliens vs Predators (2010)"	"OGDB: Aliens vs Predator (2010)"
"Amazing Alex"	"OGDB: Amazing Alex"
"Amazing Ninja"	"Amazing Ninja"
"Angry Birds Transformers"	"OGDB: Angry Birds Transformers "
"Anno Online"	"OGDB: Anno Online"
"Arcana Heart 3: LOVE MAX!!!!!"	"OGDB: Arcana Heart 3: LOVE MAX!!!!!"
"ArcheAge"	"ArcheAge"
"ArcheBlade"	"ArcheBlade"
"Arena : Cyber Evolution"	"Arena: Cyber Evolution"
"ArmA 2"	"OGDB: ArmA II"
"ArmA 3"	"OGDB: ArmA III"
"Armed Assault 3‎"	"OGDB: ArmA III"
"Army of Darkness: Defense"	"OGDB:  Army of Darkness: Defense"
"Asphalt 8: Airborne"	"Asphalt 8: Airborne"
"Assassin's Creed Rogue"	"OGDB: Assassin's Creed: Rogue"
"Assassin's Creed Unity"	"OGDB: Assassin's Creed: Unity"
"Assassins Creed Black Flag"	"OGDB: Assassin's Creed: Black Flag"
"Aura Kingdom"	"Aura Kingdom"
"AVA - Alliance of Valiant Arms"	"A.V.A - Alliance of Valiant Arms"
"Azkend"	"Azkend"
"Back to the Future: The Game"	"OGDB: Back to the Future: The Game"
"Bad Piggies"	""
"Badland (2013)"	""
"Baldur's Gate 2: Schatten von Amn"	""
"Baldur's Gate: Enhanced Edition"	""
"Banner Saga"	""
"Baphomets Fluch (1996)"	""
"Baphomets Fluch: Der Sündenfall"	""
"Batman: Arkham Knight"	""
"Battle Island"	""
"Battlefield 4/Final Stand"	""
"Battlefield Heroes"	""
"Battlefield Play4Free"	""
"Beasts of Prey"	""
"Bike Rivals"	""
"Biohazard rebirth"	""
"Bit.Trip.Runner"	""
"Bit.Trip.Runner 2"	""
"Blacklight Retribution"	""
"Blackshot"	""
"Bleach - Soul Resurreccion"	""
"Blendoku"	""
"Blitz Brigade"	""
"Blobby Volley"	""
"Blobby Volley 2"	""
"Blockstorm"	""
"Blood 2"	""
"Bloons Tower Defense 5"	""
"Book of unwritten Tales"	""
"Boom Beach"	""
"Borderlands The Pre- Sequel"	""
"Borderlands: The Pre-Sequel"	""
"Brave and Default"	""
"Bubble Witch 2 Saga"	""
"Burnout Paradise"	""
"Candy Crush"	""
"Candy Crush Saga"	""
"Candy Crush Soda Saga"	""
"Caste Ville"	""
"Castle Clash"	""
"Castle Crush"	""
"Castle story"	""
"Castlevania: Lords of Shadow – Mirror of Fate"	""
"Ceasar IV"	""
"Chariot"	""
"Chess (Jeroen Carolus)"	""
"Chess 2 - The Sequel"	""
"Civ. Beyond Earth"	""
"Civilization Beyond Earth"	""
"Civilization Revolution"	""
"Clash of Clans"	""
"Clicker heroes"	""
"Clonk Rage"	""
"Cognition: An Erica Reed Thriller"	""
"Command & Conquer: Tiberium Alliances"	""
"Command and Conquer 3: Tiberium Wars"	""
"Construction Simulator 2015"	""
"Cookie Clicker"	""
"CosmicBreak"	""
"Cosmonautica"	""
"Craft The World"	""
"Crash Bandicoot 2"	""
"Crawl"	""
"Creeper World 3 - Knuckle Cracker"	""
"Criminal Case"	""
"Croqinole"	""
"Crypt of the NecroDancer"	""
"CSI: Hidden Crimes"	""
"Curve Fever"	""
"Cut The Rope 2"	""
"Cytus"	""
"Daedelus"	""
"Danganronpa"	""
"Dark Messiah of Might and Magic"	""
"Dark Project 2: The Metal Age"	""
"Dark Souls - Prepare to Die Edition"	""
"Darkfall Online"	""
"Darkness Reborn"	""
"Darksiders 2"	""
"Das Schwarze Auge: Blackguards"	""
"Dawn of War"	""
"Dawn of War II"	""
"DayZ Standalone"	""
"DCS: A-10C Warthog - Digital Combat Simulator"	""
"Defy Gravity"	""
"Deliverance-Kingdome Comes Tech Alpha"	""
"Deponia - the Complete Journey"	""
"Deponia: The Complete Journey"	""
"Der Herr der Ringe Online"	""
"der herr der ringe schlacht um mittelerde"	""
"Der Herr der Ringe: Die Schlacht um Mittelerde 2"	""
"Despicable Me: Minion Rush"	""
"Devil's Attorney"	""
"diablo 3"	""
"Die Siedler – Aufstieg eines Königreichs"	""
"Die Siedler II – Die nächste Generation"	""
"Die Siedler Online"	""
"Die Sielder - Das Erbe der Könige"	""
"Die Stämme"	""
"Dirks kostenloser Fussballmanager"	""
"Dirt: Showdown"	""
"Dirty Bomb"	""
"Disney Infinity"	""
"Disney Infinity: 2.0 Edition"	""
"Divinity 2: Ego Draconis"	""
"Dofus"	""
"Doodle God"	""
"Doom 2"	""
"Door Kickers"	""
"Doppelkopf"	""
"DotA 1"	""
"Dota 2"	""
"Dragon Age. Inquisition"	""
"Dragon Quest IX"	""
"Drakensang Online"	""
"Dreamfall Chapters: The Longest Journey"	""
"DTM Experience 2014"	""
"Dungeon Defenders II"	""
"Dungeon Hunter 3"	""
"Dungeon Hunter 4"	""
"Dungeon of Slyn"	""
"Dungeon of the Endless"	""
"Dungeon Raid"	""
"Dungeon Village"	""
"Dungeons & Dragons: Neverwinter"	""
"Dust 514"	""
"Dwarf Fortress"	""
"Earn to Die"	""
"EDGE Extended"	""
"Elder Sign: Omens"	""
"Elsword"	""
"Emoji Quiz"	""
"Endless Dungeon"	""
"Endless Legend"	""
"Epic Cards Battle"	""
"Eschalon"	""
"Estraged"	""
"Euro Truck Simulator 2013"	""
"Euro Trucksimulator 2014"	""
"Evochron Mercenary"	""
"Evolve"	""
"F.E.A.R. 2"	""
"F1 Challenge 99-02"	""
"Fable 2"	""
"Factorio"	""
"Faery - Legends of Avalon"	""
"Family Guy: Mission Sachensuche"	""
"Fantasia: Mickey Mouse Magic"	""
"FarmVille"	""
"Farmville 2"	""
"Farmville Heroes"	""
"Fat Princess: Piece of Cake"	""
"Fate/Stay Night"	""
"FIFA World"	""
"Final Fantasy XIV: A Realm Reborn"	""
"Firefall"	""
"Fistful of Frags"	""
"Flappy Crush"	""
"Floating Point"	""
"Flow Free: Bridges"	""
"FORCED"	""
"Forge of Empires"	""
"Formel 1 2011"	""
"Fortnite"	""
"FortressCraft Evolved!"	""
"Fractured Space"	""
"Framed"	""
"Freecol"	""
"Frets on Fire"	""
"From the Depth"	""
"Frozen: Olaf's Quest"	""
"FTL: Faster Than Light"	""
"Fuchstreff: Doppelkopf für Füchse"	""
"Fußball manager 13"	"Fussball Manager 13"
"Fußball Manager 13"	"Fussball Manager 13"
"Fußball Manager 14"	"Fussball Manager 14"
"Galaxy on Fire"	""
"Game Of Thrones Ascent"	""
"Gang Beasts"	""
"Gangsters: Organized Crime"	""
"Gardenscape"	""
"Gear Up"	""
"Gender Bender DNA Twister Extreme"	""
"Geometry Dash"	""
"Ghost Recon: Future Soldier"	""
"GODUS"	""
"Godville"	""
"Goldeneye 007 (n64)"	""
"Goodgame Empire"	""
"Gothic II - Die Nacht des Raben"	""
"Grid Autosport"	""
"Grim Dawn"	""
"Grotesque Tactics 2: Dungeons and Donuts"	""
"Guilty Gear Xrd"	""
"guitar hero 6"	""
"Guns of Icarus Online"	""
"Halo - The Master Chief Collection"	""
"Halo 5: Guardians"	""
"Happy Wheels"	""
"Hardboiled Chicken"	""
"Hashi"	""
"Hawken"	""
"Haxball"	""
"Hay Day"	""
"Hazard Ops"	""
"Helden von Camelot"	""
"Heroes & Generals"	""
"Heroes Charge"	""
"Heroes of Dragon Age"	""
"Heroes of Might and Magic 2"	""
"Heroes of Might and Magic 5"	""
"Heroes of Might and Magic 6"	""
"Heroes of storm"	""
"Heroes of the Storm"	""
"Heroine's Quest: The Herald of Ragnarok"	""
"Herrscher des Olymp – Zeus"	""
"Hex: Shards of Fate"	""
"Hexcells Infinite"	""
"Highway Racer 3D"	""
"Hill Climb Racing"	""
"Hitman"	""
"Hitman GO"	""
"Horizon 2"	""
"Hyperdimension Neptunia Re;Birth1"	""
"I am Bread"	""
"Ice Age: Die Siedlung"	""
"Ice Breaker"	""
"Idle Oil Tycoon"	""
"Imouto Ijime"	""
"Indiana Jones-greatest Adventures"	""
"inFAMOUS Second Son"	""
"Infinity Wars"	""
"InflationRPG"	""
"Ingress"	""
"Insurgency: Modern Infantry Combat"	""
"Invisible Inc."	""
"InWorldz"	""
"iRacing.com"	""
"Jazz Jackrabbit 2"	""
"Kalah!"	""
"Kantai Collection"	""
"Kenshi"	""
"Kentucky Road Zero"	""
"Kentucky Route Zero"	""
"Kingdom Come: Deliverance"	""
"Kingdom Hearts 1.5 HD Remix"	""
"Kingdom hearts 2.5 HD Remix"	""
"Kingdom Hearts II HD"	""
"Kingdom of Loathing"	""
"Kingdom Rush HD"	""
"Landmark"	""
"Landwirtschafts-Simulator 2014"	""
"Last of Us"	""
"Legacy of Kain"	""
"Legend of Grimrock 2"	""
"LEGO Batman 2"	""
"LEGO City Undercover"	""
"LEGO Movie"	""
"LEGO Pirates of the Caribbean"	""
"LEGO Star Wars"	""
"LEGO: Der Hobbit"	""
"Letter Quest: Grimm's Journey"	""
"Life is Feudal"	""
"Life is Feudal: Your Own"	""
"Little Big Planet 2"	""
"LittleBigPlanet: Karting"	""
"Live for Speed"	""
"Lux Touch"	""
"Mad Games Tycoon"	""
"Madden NFL 15"	""
"Magic 2014: Duels of the Planeswalkers"	""
"Magic 2015 - Duels of the Planeswalkers"	""
"Magic: The Gathering"	""
"Magicite"	""
"MagnaCarta 2"	""
"Mahjong Tower"	""
"Mars Effect"	""
"Marvel Heroes 2015"	""
"Marvel Puzzle Quest: Dark Reign"	""
"Marvel vs StreetFighter"	""
"Mashed"	""
"Max & Mario - Die Rache des Dr. Düster"	""
"MechWarrior Online"	""
"Melody's Escape"	""
"Merchants of Kaidan"	""
"Metal Gear Solid 5: Ground Zeroes"	""
"Might & Magic Duel of Champions"	""
"Might & Magic VI: The Mandate of Heaven"	""
"Might & Magic X: Legacy"	""
"Might & Magic: Heroes 6"	""
"Might and Magic Heroes VI"	""
"Mines of Mars"	""
"Minesweeper"	""
"Minetest"	""
"Mini Metro"	""
"MiniDayZ"	""
"Minimum"	""
"MLB 14 The Show"	""
"Monopoly App"	""
"Monopoly Plus"	""
"Monster Hunter Freedom Unite"	""
"Monstermind"	""
"Mordheim: City of the Damned"	""
"Mortal Kombat (2011)"	""
"Mount&Blade: Warband"	""
"Mountain"	""
"mushroom garden"	""
"MXGP - The Official Motocross Videogame"	""
"My Lands"	""
"My Little Pony: Friendship Is Magic"	""
"Mystery Case Files: Dire Grove, Sacred Grove"	""
"Naruto Shippuuden: Narutimate Storm Revolution"	""
"NASCAR '14"	""
"Need For Speed"	""
"Need for Speed Underground 2"	""
"Need for Speed World"	""
"Need for Speed: The Crew"	""
"Neuroshima Hex"	""
"Next Car Game: Wreckfest"	""
"Ni No Kuni"	""
"Nickelodeon's The Legend of Korra"	""
"Nimble Quest"	""
"Ninja Gaiden 3 Razor's Edge"	""
"Nitro Nation Online"	""
"Nobunaga's Ambition: Souzou"	""
"NotTetris"	""
"Nuclear Throne"	""
"Octodad"	""
"Ogame"	""
"Okami"	""
"OMSI 2"	""
"Osu!"	""
"Otomaid @ Cafe"	""
"Overruled!"	""
"Pandora - First Contact"	""
"Panzer Corps: Wehrmacht"	""
"Pathfinder Online"	""
"PayDay"	""
"Pflanzen gegen Zombies 2"	""
"Pflanzen gegen Zombies: Garden Warfare"	""
"Piano Tiles (Don't Tap The White Tile)"	""
"Picmi"	""
"Picross E4"	""
"Pixel Dungeon"	""
"Plague Inc. Evolved"	""
"Plants vs. Zombie"	""
"Play Epic Battle Fantasy 4"	""
"Playstation Home"	""
"Pokémon Omega Rubin"	""
"Pokémon Showdown"	""
"Pokémon Trading Card Game Online"	""
"Pokémon: Alpha Saphir"	""
"Powerstar Golf"	""
"Primal Carnage: Extinction"	""
"Prison Rape Simulator 2014"	""
"Project CARS"	""
"Quizduell"	""
"Race Driver: GRID"	""
"RaceRoom Racing Experience"	""
"Rage of Bahamut"	""
"Ragnarok Online 2"	""
"Rail Nation"	""
"Rebuild 2"	""
"Recruits - Make Heroes. Make History"	""
"Reflec Beat plus!"	""
"Remeber Me"	""
"Renegade-x"	""
"ReRave"	""
"Resident Evil: Darkside Chronicles"	""
"Rise of Flight"	""
"Robocraft"	""
"RockBand"	""
"Rockband 3"	""
"Rune Factory Frontier"	""
"Runescape"	""
"Running with Rifles"	""
"Rust"	""
"S.K.I.L.L.-Special Force 2"	""
"S.N.O.W."	""
"S.O.L : Stone of Life EX"	""
"S4 League"	""
"salt"	""
"Sauspiel Schafkopf"	""
"Scarlet Blade"	""
"School of Dragons"	""
"Scrabble (Smartphone)"	""
"Screencheat"	""
"Scrolls"	""
"Senran Kagura Shinovi Versus"	""
"Serious Sam 2 HD"	""
"Shadow Kings"	""
"Shadow Warrior (2013)"	""
"Shakes & Fidget"	""
"Shakes and Fidget"	""
"Sherlock Holmes and the Hound of Baskervilles"	""
"Sherlock Holmes: Crimes and Punishments"	""
"ShootMania"	""
"Sideswiped"	""
"Sightline: The Chair"	""
"Silent Hill (1999)"	""
"Silent Hunter 3"	""
"Silent Hunter 4"	""
"Sim City (2013)"	""
"Simcity 2000 (1994)"	""
"SimCity 4"	""
"Sins of the Dark Age"	""
"Skull Girls"	""
"Skylanders: Trap Team"	""
"Slenderman"	""
"Small World"	""
"Smite"	""
"Smugglers 5"	""
"Sniper Elite 3"	""
"Söldner – Secret Wars"	""
"SolForge"	""
"Sonic Boom: Rise of Lyric"	""
"Space Age: A Game of Space Adventure"	""
"Space Engieeners"	""
"Space Hulk: Ascension Edition"	""
"Space Run"	""
"Space Trader (Eigenproduktion)"	""
"Spider Solitaire"	""
"Spider-Man Unlimited"	""
"Spin Tires"	""
"Spirit Stones"	""
"Split Second: Velocity"	""
"Star Citizen"	""
"Star Conflict"	""
"Star Made"	""
"Star Pirates"	""
"Star Wars Jedi Knight: Jedi Academy"	""
"Star Wars: Commander"	""
"Star Wars: Episode III – Die Rache der Sith"	""
"Star Wars: Force Collection"	""
"Star Wars: Jedi Knight 2: Jedi Outcast"	""
"Star Wars: The Battle of Endor"	""
"Star Wars: The Force Unleashed 2"	""
"Star Wars: Tiny Death Star"	""
"Starwhal"	""
"Steins;Gate"	""
"Stick Hero"	""
"Stonehearth"	""
"Strategic Command Global Conflict"	""
"Strategic Command World War 1"	""
"Streetpass Mii-Lobby"	""
"Stronghold Crusader"	""
"Stronghold Crusader 2"	""
"Stronghold Crusader HD"	""
"Subway Surfer"	""
"Subway Surfers"	""
"Sudoku Free"	""
"Summoners War: Sky Arena"	""
"Sunless Sea"	""
"Sunrider"	""
"Super Smash Bros Wii U"	""
"Super Street Fighter V"	""
"Survarium"	""
"SWAT 3"	""
"Tactical Ops"	""
"Tales from the Borderlands"	""
"Tales of Aravorn: Seasons Of The Wolf"	""
"Tangled"	""
"Teeworlds"	""
"Teleglitch"	""
"Temple Run"	""
"Temple Run 2"	""
"Tera Online"	""
"Terra Battle"	""
"Tetris Ultimate"	""
"Texas Hold'Em King 2"	""
"The Age of Decadence"	""
"The Battle for Wesnoth"	""
"The Binding of Isaac. Rebirth"	""
"The Curious Expedition"	""
"The Escapist"	""
"The Expandabros"	""
"The G.G. Shinobi"	""
"The Last Of Us: Factions"	""
"The Last of Us: Remastered"	""
"The Last Tinker: City of Colors"	""
"The Masterplan"	""
"The Organ Trail"	""
"The Sailor's Dream"	""
"The Secret of Monkey Island - Special Edition"	""
"The Simpsons: Springfield"	""
"The Simpsons: Tapped Out"	""
"The Talos Principle"	""
"The Thirty-Nine Steps"	""
"The Walking Dead"	""
"the walking dead telltall"	""
"The Wolf Among Us"	""
"Theatrhythm Final Fantasy: Curtain Call"	""
"TheHunter"	""
"Thief 4"	""
"Time Ramesside"	""
"Tiny and Big: Grandpa's Leftovers"	""
"Tiny Tower"	""
"TITAN ATTACKS"	""
"Tom Clancy's Ghost Recon Advanced Warfighter"	""
"TOME: Immortal Arena"	""
"Top Eleven"	""
"Total War Battles: Kingdom"	""
"Total War: Shogun"	""
"TowerFall Ascension"	""
"Township"	""
"Townsmen"	""
"TrackMania 2"	""
"Trackmania Nations Forever"	""
"Traffic Racer"	""
"Train Simulator 2015"	""
"TransOcean: The Shipping Company"	""
"TRI: Of Friendship and Madness"	""
"Trials: Frontier"	""
"Trove"	""
"Turbo Dismount"	""
"Uncharted 3"	"Uncharted 3: Drake's Deception"
"Und mehr"	"?"
"Underworld Empire"	"?"
"Uniwar"	"?"
"Unturned"	"?"
"Vainglory"	"?"
"Vampire the Masquerade: Bloodlines"	"Vampire: The Masquerade - Bloodlines"
"Vector Thrust"	"?"
"Vindictus"	"?"
"Volo Airsport"	"?"
"WAKFU"	"?"
"War in the Pacific"	"?"
"Warlock: Master of Arcane"	"Warlock: Master of the Arcane"
"Warmachine: Tactics"	"?"
"Wimmelbildspiele (Big Fish)"	"?"
"Wings of Vi"	"Battle of Britain II: Wings of Victory"
"Wizard's Choice"	"?"
"World Cruise Story"	"?"
"World War II Online"	"?"
"Worms: Reloaded"	"Worms Reloaded"
"WRC 4 FIA World Rally Championship"	"WRC: FIA World Rally Championship"
"WWE 2k13"	"?"
"WWE Smackdown vs. Raw 2008"	""
"X-Plane 10"	"X-Plane 10: Global"
"X: Superbox"	"?"
"X3: Albion Prelude"	"X³: Albion Prelude"
"X3: Gold Edition"	"?"
"X3: Terran Conflict"	"X³: Terran Conflict"
"XCOM UFO Defense"	"X-COM: UFO Defense"
"XStoryPlayer 3.0"	"?"
"YGOPro DevPro"	"?"
"Zengrams"	"?"
"Zombie Roadkill"	"?"
"Zombies vs. Plants"	"?"
"Zug um Zug"	"?"
